Capital de Francia|paris
Elemento químico con símbolo O|oxigeno
Autor de Don Quijote|cervantes
Planeta más cercano al sol|mercurio
Color resultante de mezclar azul y amarillo|verde
Río más largo del mundo|nilo
Número de patas de una araña|ocho
País donde se inventó la pizza|italia
Lengua oficial de Brasil|portugues
Animal que pone huevos y vuela|pato
Capital de Alemania|berlin
Metal líquido a temperatura ambiente|mercurio 
Autor de "Cien años de soledad"|gabriel
Número de planetas del sistema solar|ocho
Moneda oficial de Japón|yen
Animal terrestre más rápido|guepardo
País con mayor población del mundo|china
Continente donde se encuentra Egipto|africa
Color de la sangre|rojo
Idioma más hablado del mundo|ingles
Órgano responsable de bombear la sangre|corazon
Comida típica de Japón hecha con arroz y pescado|sushi
País de origen del tango|argentina
Año en que terminó la Segunda Guerra Mundial|1945
Instrumento musical de cuerdas y arco|violin
Gas que respiramos para vivir|oxigeno
Ciudad donde está la Torre Eiffel|paris
Lengua oficial de Canadá (una de ellas)|frances
Mar más grande del mundo|marcaspio
Nombre del satélite natural de la Tierra|luna
Animal símbolo de Australia|canguro
Nombre del pintor de La Mona Lisa|daVinci
Estación del año en la que caen las hojas|otono
Número de días que tiene un año bisiesto|366
Planeta conocido como el planeta rojo|marte
Nombre del océano entre América y Europa|atlantico
Aparato para ver objetos a distancia|telescopio
País donde se celebraron los primeros Juegos Olímpicos|grecia
Ciencia que estudia los seres vivos|biologia
Animal con una sola joroba|dromedario
Nombre del proceso por el que las plantas hacen su alimento|fotosintesis
Raza de perro pequeña y peluda|caniche
Color del sol al atardecer|naranja
País conocido por la torre inclinada de Pisa|italia
Nombre del continente helado|antartida
Científico que propuso la teoría de la relatividad|einstein
Sistema usado para contar en informática|binario
Animal con caparazón que camina lento|tortuga
Fruta tropical amarilla por fuera y blanca por dentro|platano